{
id: MAP
map: [
	[
		[ 16, 16, 16, 16, 16, 16, 16, 16, 16, 16, 16, 16, 16, 16, 16, 16, 16, 16, 16, 16, 16, 16, 16, 16, 16 ]
		[ 16, 16, 16, 16, 16, 16, 16, 16, 16, 16, 16, 16, 16, 16, 16, 16, 16, 16, 16, 16, 16, 16, 16, 16, 16 ]
		[ 16, 16, 9, 16, 11, 5, 5, 5, 12, 16, 16, 11, 5, 5, 5, 15, 16, 9, 16, 11, 5, 18, 15, 16, 16 ]
		[ 16, 16, 13, 5, 1, 24, 4, 1, 24, 16, 11, 1, 24, 1, 24, 22, 11, 1, 24, 1, 24, 22, 23, 16, 16 ]
		[ 16, 16, 21, 13, 1, 24, 22, 13, 6, 16, 3, 1, 24, 6, 16, 11, 1, 24, 1, 24, 1, 24, 12, 16, 16 ]
		[ 16, 16, 9, 22, 3, 1, 24, 22, 3, 18, 1, 24, 1, 24, 5, 1, 24, 4, 1, 24, 1, 24, 6, 16, 16 ]
		[ 16, 16, 8, 16, 3, 1, 24, 5, 14, 22, 3, 1, 24, 4, 1, 24, 6, 22, 17, 16, 13, 1, 24, 16, 16 ]
		[ 16, 16, 20, 11, 1, 24, 16, 17, 22, 11, 1, 24, 14, 22, 13, 1, 24, 5, 4, 12, 22, 13, 6, 16, 16 ]
		[ 16, 16, 16, 3, 1, 24, 5, 1, 24, 4, 6, 16, 23, 16, 21, 3, 1, 24, 22, 8, 16, 21, 17, 16, 16 ]
		[ 16, 16, 10, 1, 24, 1, 24, 14, 16, 22, 17, 16, 9, 16, 16, 13, 1, 24, 12, 20, 16, 10, 6, 16, 16 ]
		[ 16, 16, 21, 17, 16, 3, 6, 22, 11, 5, 1, 24, 1, 24, 16, 21, 3, 1, 24, 5, 12, 22, 17, 16, 16 ]
		[ 16, 16, 11, 4, 5, 1, 24, 5, 1, 24, 1, 24, 14, 16, 10, 5, 4, 6, 16, 13, 1, 24, 6, 16, 16 ]
		[ 16, 16, 17, 22, 3, 4, 1, 24, 4, 1, 24, 6, 22, 19, 22, 17, 22, 17, 16, 21, 3, 1, 24, 16, 16 ]
		[ 16, 16, 3, 5, 6, 22, 3, 6, 22, 17, 16, 17, 16, 20, 10, 1, 24, 1, 24, 5, 1, 24, 6, 16, 16 ]
		[ 16, 16, 13, 1, 24, 5, 4, 4, 5, 1, 24, 1, 24, 15, 22, 3, 1, 24, 1, 24, 1, 24, 6, 16, 16 ]
		[ 16, 16, 21, 8, 16, 8, 22, 22, 3, 1, 24, 1, 24, 22, 11, 1, 24, 1, 24, 1, 24, 1, 24, 16, 16 ]
		[ 16, 16, 16, 20, 9, 20, 11, 5, 1, 24, 1, 24, 1, 24, 4, 6, 16, 13, 1, 24, 1, 24, 6, 16, 16 ]
		[ 16, 16, 11, 5, 1, 24, 1, 24, 6, 16, 3, 1, 24, 6, 22, 3, 12, 22, 3, 1, 24, 1, 24, 16, 16 ]
		[ 16, 16, 3, 1, 24, 1, 24, 4, 1, 24, 1, 24, 1, 24, 16, 3, 1, 24, 1, 24, 16, 17, 16, 16, 16 ]
		[ 16, 16, 13, 6, 16, 3, 6, 22, 13, 4, 4, 4, 1, 24, 18, 1, 24, 1, 24, 1, 24, 1, 24, 16, 16 ]
		[ 16, 16, 21, 3, 5, 1, 24, 16, 21, 22, 22, 22, 3, 6, 22, 3, 1, 24, 16, 13, 4, 1, 24, 16, 16 ]
		[ 16, 16, 11, 4, 1, 24, 6, 16, 10, 5, 5, 5, 4, 1, 24, 4, 6, 16, 9, 22, 22, 3, 14, 16, 16 ]
		[ 16, 16, 8, 22, 8, 16, 8, 16, 21, 13, 4, 14, 22, 8, 16, 22, 8, 16, 13, 18, 18, 14, 23, 16, 16 ]
		[ 16, 16, 20, 16, 20, 16, 20, 16, 16, 21, 22, 23, 16, 20, 16, 16, 20, 16, 21, 22, 22, 23, 16, 16, 16 ]
		[ 16, 16, 16, 16, 16, 16, 16, 16, 16, 16, 16, 16, 16, 16, 16, 16, 16, 16, 16, 16, 16, 16, 16, 16, 16 ]
	]
	[
		[ 0, 0, 0, 0, 0, 0, 0, 0, 0, 0, 0, 0, 0, 0, 0, 0, 0, 0, 0, 0, 0, 0, 0, 0, 0 ]
		[ 0, 0, 0, 0, 0, 0, 0, 0, 0, 0, 0, 0, 0, 0, 0, 0, 0, 0, 0, 0, 0, 0, 0, 0, 0 ]
		[ 0, 0, 0, 0, 0, 0, 0, 0, 0, 0, 0, 0, 0, 0, 0, 0, 0, 0, 0, 0, 0, 0, 0, 0, 0 ]
		[ 0, 0, 0, 0, 0, 0, 0, 0, 0, 0, 0, 0, 0, 0, 0, 0, 0, 0, 0, 0, 0, 0, 0, 0, 0 ]
		[ 0, 0, 0, 0, 0, 0, 0, 0, 0, 0, 0, 0, 0, 0, 0, 0, 0, 0, 0, 0, 0, 0, 0, 0, 0 ]
		[ 0, 0, 0, 0, 0, 0, 0, 0, 0, 0, 0, 0, 0, 0, 0, 0, 0, 0, 0, 0, 0, 0, 0, 0, 0 ]
		[ 0, 0, 0, 0, 0, 0, 0, 0, 0, 0, 0, 0, 0, 0, 0, 0, 0, 0, 0, 0, 0, 0, 0, 0, 0 ]
		[ 0, 0, 0, 0, 0, 0, 0, 0, 0, 0, 0, 0, 0, 0, 0, 0, 0, 0, 0, 0, 0, 0, 0, 0, 0 ]
		[ 0, 0, 0, 0, 0, 0, 0, 0, 0, 0, 0, 0, 0, 0, 0, 0, 0, 0, 0, 0, 0, 0, 0, 0, 0 ]
		[ 0, 0, 0, 0, 0, 0, 0, 0, 0, 0, 0, 0, 0, 0, 0, 0, 0, 0, 0, 0, 0, 0, 0, 0, 0 ]
		[ 0, 0, 0, 0, 0, 0, 0, 0, 0, 0, 0, 0, 0, 0, 0, 0, 0, 0, 0, 0, 0, 0, 0, 0, 0 ]
		[ 0, 0, 0, 0, 0, 0, 0, 0, 0, 0, 0, 0, 0, 0, 0, 0, 0, 0, 0, 0, 0, 0, 0, 0, 0 ]
		[ 0, 0, 0, 0, 0, 0, 0, 0, 0, 0, 0, 0, 0, 0, 0, 0, 0, 0, 0, 0, 0, 0, 0, 0, 0 ]
		[ 0, 0, 0, 0, 0, 0, 0, 0, 0, 0, 0, 0, 0, 0, 0, 0, 0, 0, 0, 0, 0, 0, 0, 0, 0 ]
		[ 0, 0, 0, 0, 0, 0, 0, 0, 0, 0, 0, 0, 0, 0, 0, 0, 0, 0, 0, 0, 0, 0, 0, 0, 0 ]
		[ 0, 0, 0, 0, 0, 0, 0, 0, 0, 0, 0, 0, 0, 0, 0, 0, 0, 0, 0, 0, 0, 0, 0, 0, 0 ]
		[ 0, 0, 0, 0, 0, 0, 0, 0, 0, 0, 0, 0, 0, 0, 0, 0, 0, 0, 0, 0, 0, 0, 0, 0, 0 ]
		[ 0, 0, 0, 0, 0, 0, 0, 0, 0, 0, 0, 0, 0, 0, 0, 0, 0, 0, 0, 0, 0, 0, 0, 0, 0 ]
		[ 0, 0, 0, 0, 0, 0, 0, 0, 0, 0, 0, 0, 0, 0, 0, 0, 0, 0, 0, 0, 0, 0, 0, 0, 0 ]
		[ 0, 0, 0, 0, 0, 0, 0, 0, 0, 0, 0, 0, 0, 0, 0, 0, 0, 0, 0, 0, 0, 0, 0, 0, 0 ]
		[ 0, 0, 0, 0, 0, 0, 0, 0, 0, 0, 0, 0, 0, 0, 0, 0, 0, 0, 0, 0, 0, 0, 0, 0, 0 ]
		[ 0, 0, 0, 0, 0, 0, 0, 0, 0, 0, 0, 0, 0, 0, 0, 0, 0, 0, 0, 0, 0, 0, 0, 0, 0 ]
		[ 0, 0, 0, 0, 0, 0, 0, 0, 0, 0, 0, 0, 0, 0, 0, 0, 0, 0, 0, 0, 0, 0, 0, 0, 0 ]
		[ 0, 0, 0, 0, 0, 0, 0, 0, 0, 0, 0, 0, 0, 0, 0, 0, 0, 0, 0, 0, 0, 0, 0, 0, 0 ]
		[ 0, 0, 0, 0, 0, 0, 0, 0, 0, 0, 0, 0, 0, 0, 0, 0, 0, 0, 0, 0, 0, 0, 0, 0, 0 ]
	]
]
}